1111111111111111111111111111111111111111111111111111111111111111111111111
1111111111111111111111111111111111111111111111111111111111111111111111111
1111111111111111111111111111111111111111111111111111111111111111111111111
1111111111111111111111111111111111111111111111111111111111111111111111111
1111111000000000000000000000000000000000000000000000000000000000011111111
1111111000000000000000000000000000000000000000000000000000000000011111111
1111111000000000000000000000000000000000000000000000000000000000011111111
111111100000000000000000000000000000000000000000000000000PCE0000011111111
1111111000000000000000000000000000000000000000000000000000000000011111111
1111111000000000000000000000000000000000000000000000000000000000011111111
1111111000000000000000000000000000000000000000000000000000000000011111111
1111111000000000000000000000000000000000000000000000000000000000011111111
1111111000000000000000000000000000000000000000000000000000000000011111111
1111111000000000000000000000000000000000000000000000000000000000011111111
1111111000000000000000000000000000000000000000000000000000000000011111111
1111111000000000000000000000000000000000000000000000000000000000011111111
1111111000000000000000000000000000000000000000000000000000000000011111111
1111111000000000000000000000000000000000000000000000000000000000011111111
1111111000000000000000000000000000000000000000000000000000000000011111111
1111111000000000000000000000000000000000000000000000000000000000011111111
1111111000000000000000000000000000000000000000000000000000000000011111111
1111111000000000000000000000000000000000000000000000000000000000011111111
1111111000000000000000000000000000000000000000000000000000000000011111111
1111111000000000000000000000000000000000000000000000000000000000011111111
1111111000000000000000000000000000000000000000000000000000000000011111111
1111111000000000000000000000000000000000000000000000000000000000011111111
1111111000000000000000000000000000000000000000000000000000000000011111111
1111111000000000000000000000000000000000000000000000000000000000011111111
1111111000000000000000000000000000000000000000000000000000000000011111111
1111111000000000000000000000000000000000000000000000000000000000011111111
1111111000000000000000000000000000000000000000000000000000000000011111111
1111111000000000000000000000000000000000000000000000000000000000011111111
1111111000000000000000000000000000000000000000000000000000000000011111111
1111111000000000000000000000000000000000000000000000000000000000011111111
1111111000000000000000000000000000000000000000000000000000000000011111111
1111111000000000000000000000000000000000000000000000000000000000011111111
1111111000000000000000000000000000000000000000000000000000000000011111111
1111111000000000000000000000000000000000000000000000000000000000011111111
1111111000000000000000000000000000000000000000000000000000000000011111111
1111111000000000000000000000000000000000000000000000000000000000011111111
1111111000000000000000000000000000000000000000000000000000000000011111111
1111111000000000000000000000000000000000000000000000000000000000011111111
1111111000000000000000000000000000000000000000000000000000000000011111111
1111111000000000000000000000000000000000000000000000000000000000011111111
1111111111111111111111111111111111111111111111111111111111111111111111111
1111111111111111111111111111111111111111111111111111111111111111111111111
1111111111111111111111111111111111111111111111111111111111111111111111111
1111111111111111111111111111111111111111111111111111111111111111111111111
