11111
10101
100E1
101P1
11111
