11111
1C101
100E1
101P1
11111
